|0, 1, 1, 1, 1, 1, r, X, 
|1, 1, 1, 1, 0, X, 1, X, 
|1, 1, 1, 1, X, 0, 1, X, 
|1, 1, X, 1, 1, 1, 1, X, 
|1, 1, 1, 1, 1, 1, 1, X, 
|X, X, X, X, X, 0, X, 0, 
