|r, 1, 1, 1, 1, 1, 1, X, 
|1, 1, 1, 1, 0, X, 1, X, 
|1, 1, 1, 1, X, 0, 1, X, 
|1, 1, X, 1, 1, 1, 1, X, 
|1, 1, 1, 1, 1, 1, 1, X, 
|X, X, X, X, X, X, X, 0, 
